

NO           ./tex/north.xpm
S ./tex/sprite.xpm

F                       49,99,0

SO ./tex/south.xpm
WE                                   ./tex/west.xpm

EA                ./tex/east.xpm

C           105,240,235
R                800               600

    11
    1111111111111111111111111111111111111  
1111100000000000000000000000011000001
1000000000000000E00002220000011111111
100000000000000000000000000000000001111111111111111111111
100111110000000000000000002001100000000000000000000000021
1021  110000000000000000000001100000111111110111111111111
1111  1100111111111110001111111100011      1011
      11001         100011111111010111111111011
      1101111111111110001      1200000000000001
      1100000000000000011      1111111111111111
      1111111111111110011
                   111111   1111111111111
                            1111111111111
